BACKWARD	B AE K W ER D
BALL	B AO L
CAN	K AE N
CAN(2)	K AH N
FATHER	F AA DH ER
FIND	F AY N D
FORWARD	F AO R W ER D
HI	HH AY
HOW	HH AW
INTRUDUCE	IH N T R UW D Y UW S
IS	IH Z
LEFT	L EH F T
MANY	M EH N IY
MOVE	M UW V
MYRO	M IH R OW
PEOPLE	P IY P AH L
RIGHT	R AY T
SEE	S IY
STOP	S T AA P
THE	DH AH
THE(2)	DH IY
TURN	T ER N
WHO	HH UW
YOU	Y UW
YOUR	Y AO R
YOUR(2)	Y UH R
YOURSELF	Y ER S EH L F
YOURSELF(2)	Y UH R S EH L F
YOURSELF(3)	Y AO R S EH L F
